11111
1C111
100E1
10011
10P01
11111
